################
#T.....#......M#
#......#.......#
#####......#####
#..............#
#P............P#
#M....SA......T#
###............#
E..............#
#######....#####
#..............#
#M.#..........T#
################